#.#.#########...###.#.#
.............---.......
#.#.##  ######-##.#.#.#
#.#.##  ....##.#..#.#.#
#.#.##  ###.###...#.#.#
#...##  ##....##.##...#
#.###...#......##...#.#
#.###.--#.#..#.#.#.##.#
#.###.--......   ..##.#
#.###.#.#..#.# .###...#
#.###.-....... ..###..#
#.###.--#.#..#.#.##.#.#
#.###....... ...###...#
#.#..###--.#######....#
#.###...#..#...###....#
#.#.....#...#.....#...#
#.#........#.....##.#.#
#.#...w....#....##..#.#
#.#...w......##.....#.#
#.####w##..#######....#
.......................
########        ####...