#.#.#########...###.#.#
.............---.......
#.#.##  ######-##.#.#.#
#.#.##  ....##.#..#.#.#
#.#.##  ###.###...#.#.#
#...##  ##....##.##...#
#.###..........##...#.#
#.###.--#.#..#.#.#.##.#
#.###.--......   ..##.#
#.###.#.#..#.# .###...#
#.###.-....... ..###..#
#.###.--#.#..#.#.##.#.#
#.###....... ...###...#
#.######--.#######....#
#.###...#..#...###....#
#.#...#..-....#...#...#
#.#.###### ####..##.#.#
#.#.##..- ......##..#.#
#.#....#--#..##.....#.#
#.#######..#######....#
.......................
########        ####...